24 22
###########
##########        #####
########         ######
######    |      ######
####     ##      ######
  |      ###     ######
>       ###       #####
|      #####      #####
###     #####      ####
####    #######
####     ########
         ######    #
####      #####     #
######     #####    #
####       #####   ##
####       ####    ##
#######    ###     ##
  #####    ##      ##
  #####            ##
            |      ##
     ##     ###    ##
     ##   ######
     ##   ######
     ##   #######
0 11